##################
#                #
#                #
#                #
#   ##########   #
#  #          #  #
# #            # #
##             # #
#  ############# #
#                #
#                #
##################
