##################
#                #
#                #
#       ##       #
#                #
#    #      #    #
#    #      #    #
#                #
#       ##       #
#                #
#                #
##################
