##################
#                #
#                #
#  ##        ##  #
#  #          #  #
#                #
#                #
#  #          #  #
#  ##        ##  #
#                #
#                #
##################
