################
#              #
#  ##      ##  #
#  ##      ##  #
#              #
#              #
#              #
#              #
#  ##      ##  #
#  ##      ##  #
#              #
################
