##################
##              ##
##   ##     ##  ##
##   ##     ##  ##
##              ##
##              ##
##              ##
##              ##
##   ##     ##  ##
##   ##     ##  ##
##              ##
##################
